g a a a a a a a a a a a a a a a
a a a a a a a a a a a a a a a a
a a a a a a a a a a a a a a a a
a a a a a a a a a a a a a a a a
a a a a a a a a a a a a a a a a
a a a a a a a a a a a a a a a a
a a a a a a a a a a a a a a a a
a a a a a a a a a a a a a a a a
a a a a a a a a a a a a a a a a
a a a a a a a a a a a a a a a a
a a a a a a a a a a a a b b b b
a a a a a a a a a a a a b 1 4 2
a a a a a a a a a a a a b b b b
a a a a a a a a a a a a b u 3 2
a a a a a a a a a a a a b a b 1
a a a a a a a a a a a a b 3 4 p
step6