g 6 a a a a a a a a a a a a a a
a a a 6 a a a a a a a a a a a a
a a a 5 a a a a a a a a a a a a
a 4 5 a a a a a a a a a a a a a
a a a a a a a a a a a a a a a a
a a a a a a a a a a a a a a a a
a a a a a a a a a a a a a a a a
a a a a a a a a a a a a 4 a a a
a a a a a a a a a a a a 3 a a a
a a a a a a a a a a a a a a a a
a a a a a a a a a a a a a a a a
a a a a a a a a a a a a a a a a
a a a a a a a a a a a a a a a a
a a a a a a a a a a a a a a 3 2
a a a a a a a a a a a a a 1 2 1
a a a a a a a a a a a a a a a p
step9